NORM:
'W' = wall ext
'w' = wall int
' ' = floor
'e' = elevator
't' = table
'C' = chair
'c' = carpet
&
WWWWWWWWWWWWWWWWWWWWWWWWWWWWWWWW
W   w      w ee w              W
W   w      w    w              W
W   w      w    w   wwwwwwwwwwwW
W   w   w                      W
W   w   w                      W
W   w   w  wwwwwwwww   w       W
W       w              w       W
W       w              w       W
W       w  wwwwwwwww   w       W
Wwwwwwwww              w       W
W                      w       W
W                w     w       W
W  wwwwwwwwwww   w     wwwwwwwwW
W            w   w             W
W            w   w             W
W            w   w             W
WWWWWWWWWWWWWWWWWWWWWWWWWWWWWWWW
!
9
Gangster 840 480
Gangster 100 250
Gangster 1500 100
Gangster 1700 120
Gangster 1600 500
Gangster 1550 900
Gangster 1200 950
Hoods 150 100
Hoods 700 950
&
WWWWWWWWWWWWWWWWWWWWWWWWWWWWWWWW
W     w  ee  w ee w            W
W     w      w    w   w        W
W            w        w        W
W     wwwwwwwwwwwwwwwww        W
W                     w   wwwwwW
W                     w   w    W
W             w       w   w    W
W    w                w   w  wwW
W    w                w        W
W    w                w        W
W    w        w       w        W
W    w                w        W
W    w                w        W
W    w      wwww      w        W
W              w               W
W              w               W
WWWWWWWWWWWWWWWWWWWWWWWWWWWWWWWW
!
10
Gangster 240 180
Gangster 660 180
Hoods 1800 180
Durag 1860 480
Gangster 720 420
Gangster 1200 480
Gangster 1740 840
Hoods 720 840
Hoods 240 780
Gangster 900 960
