NORM:
'W' = wall ext
'w' = wall int
' ' = floor
'e' = down elevator
'E' = up elevator
'C' = chair
'c' = carpet
&
WWWWWWWWWWWWWWWWWWWWWWWWWWWWWWWW
W   w      w EE w              W
W   w      w    w              W
W   w      w    w   wwwwwwwwwwwW
W   w   w                      W
W   w   w                      W
W   w   w  wwwwwwwww   w       W
W       w              w       W
W       w              w       W
W       w  wwwwwwwww   w       W
Wwwwwwwww              w       W
W                      w       W
W                w     w       W
W  wwwwwwwwwww   w     wwwwwwwwW
W            w   w             W
W            w   w             W
W            w   w             W
WWWWWWWWWWWWWWWWWWWWWWWWWWWWWWWW
!
9
Gangster 840 480
Gangster 100 250
Gangster 1500 100
Gangster 1700 120
Gangster 1600 500
Gangster 1550 900
Gangster 1200 950
Hoods 150 100
Hoods 700 950
&
WWWWWWWWWWWWWWWWWWWWWWWWWWWWWWWW
W     w  EE  w ee w            W
W     w      w    w   w        W
W            w        w        W
W     wwwwwwwwwwwwwwwww        W
W                     w   wwwwwW
W                     w   w    W
W             w       w   w    W
W    w                w   w  wwW
W    w                w        W
W    w                w        W
W    w        w       w        W
W    w                w        W
W    w                w        W
W    w      wwww      w        W
W              w               W
W              w               W
WWWWWWWWWWWWWWWWWWWWWWWWWWWWWWWW
!
10
Gangster 240 180
Gangster 660 180
Hoods 1800 180
Durag 1860 480
Gangster 720 420
Gangster 1200 480
Gangster 1740 840
Hoods 720 840
Hoods 240 780
Gangster 900 960
&
WWWWWWWWWWWWWWWWWWWWWWWWWWWWWWWW
W            w         w       W
W            w         w       W
Wwwwwwwwww   w   w     w       W
W        w   w   wwww  w       W
W        w   w   w     w       W
W    w   w   w   w     w  www  W
W    w       w   w     w       W
W    w       w   w     w       W
Ww  wwwwwwwwww   w     w       W
W    w   w       w     w       W
W    w   w       w     w       W
W    w   w       w  wwww       W
W        w       w     w       W
W        w       w     w       W
W                w             W
W                w             W
WWWWWWWWWWWWWWWWWWWWWWWWWWWWWWWW
!
13
Hoods 120 120
Hoods 450 400
Gangster 650 500
Durag 100 650
Durag 450 650
Gangster 900 700
Gangster 1150 200
Durag 1200 400
Gangster 1300 650
Hoods 1250 900
Gangster 1650 500
Durag 1600 120
Durag 1700 120
&
WWWWWWWWWWWWWWWWWWWWWWWWWWWWWWWW
W                              W
W                              W
W                              W
W                              W
W                              W
W                              W
W                              W
W                              W
W                              W
W                              W
W                              W
W                              W
W                              W
W                              W
W                              W
W                              W
WWWWWWWWWWWWWWWWWWWWWWWWWWWWWWWW
!
1
OUSMANESEISME 0 0
